22222222222222222222222222222222
20000000000000000000000000000002
20000000000000000000000000000002
20000000000000000000000000000002
20000000000002222200000000000002
20000000000002444200000000000002
20000000020000333000020000000002
20000000020000000000020000000002
20000000020000010000020000000002
20000000020000000000020000000002
20000000020000000000020000000002
20000000000000000000000000000002
20000000000000000000000000000002
20000000000000000000000000000002
20000000000000000000000000000002
20000000000000000000000000000002
20000000000000000000000000000002
22222222222222222222222222222222