22222222
24200002
24213202
20300002
20022222
2222