22222222222
22222200002
20442030002
20443130202
20002003002
22222220002
22222222222