22222222222222222222222222222222
20000000000000000000000000000002
20000000000000000000000000000002
20000100000000000000000000100002
20000000000000000000000000000002
20000000000000000000000000000002
20000000020000040000020000000002
20000000020000030000020000000002
20000000020004313400020000000002
20000000020000030000020000000002
20000000020000040000020000000002
20000000000000000000000000000002
20000000000000000000000000000002
20000000000000000000000000000002
20000100000000000000000000000002
20000000000000000000000000000002
20000000000000000000000000000002
22222222222222222222222222222222