22222222222222222222222222222222
20000000000000000000000000000002
20000000000000000000000000000002
20000000000000000000000000000002
20000000000000000000000000000002
20000000000000000000000000000002
20000000020000000000020000000002
20000000020000000000020000000002
20000000020000010030420000000002
20000000020000000000020000000002
20000000020000000000020000000002
20000000000000000000000000000002
20000000000000000000000000000002
20000000000000000000000000000002
20000000000000000000000000000002
20000000000000000000000000000002
20000000000000000000000000000002
22222222222222222222222222222222