22222222222222222222222222222222
21000000000000000000000000000342
22222222222222202222222222222222
20000000000000000000000000000002
20200020003300000040000400000002
20020200030030000040000400000002
20002000300003000040000400000002
20002000300003000040000400000002
20002000030030000040000400000002
20002000003300000004444000000002
20000000000000000000000000000002
20200020002000500040000400220002
20200202002000500044000400220002
20202000202000500040400400220002
20220000022000500040040400220002
20200000002000500040004000000002
20200000002000500040000400440002
22222222222222222222222222222222